#............#
#...........$#
#.....##...###
#....###..##.
#@..##.#.###..
#####..#...#..
.......##..#..
.......###.#..
.......#...#..
.......#..##..
.......#.###..
.......#.......^
.......#############
.......###..*..#####
.......#############