######################
##..*.#........###.-.#
#$..............##$..#
#........_.......###.#
#....#..###..........#
#.@.###*.$...*#.........^
##################################